ablaze -> ablave -> esterday deals of t
Sacred -> Sicred -> terminated by sicre
promise -> prqmise -> esesesesesesesesese
arrange -> arrangj -> arrangj2013arrangj2
conditioned -> cocditioned -> tioneditioneditione
refrain -> rufrain -> ansatsjufraingeniö
Coll -> Ckll -> lls klls klls klls 
Tactical -> Tacticol -> ttacticolttacticolt
regimen -> regimyn -> eneregimyneregimyne
Slow -> Sloc ->  stereotypowania a 
insurrectionists -> ifsurrectionists -> rectionistrectionis
Māori -> Mnori -> MnoriMMMnoriMMMMMMM
silken -> silknn -> nner silknner silkn
nature -> natury -> aturyaturyaturyatur
poop -> noop -> noopsnoopsnoopsnoop
often -> oftek -> informations
ftekin
stunts -> sxunts -> syuntskyuntskyuntsk
slave -> sxave -> s translations more
drag -> drsg -> drsgdrsgdrsgdrsgdrs
constrained -> sonstrained -> donttototototototot
slid -> sliv ->  a s a s a s a s a 
Doughty -> noughty -> noughtyanoughtyanou
Torquay -> Torquam -> mquamquamquamTorqua
Companion -> Coqpanion -> e era of Mercklion 
sacrifices -> sacrifyces -> acrifycesacrifycesa
aged -> sged -> gedwasgedwasgedwasg
Filmmaker -> Filmoaker ->  a sa ma de sa ma d
Olympic -> Olympig -> ing the Corona Viru
ruptures -> ruptuwes -> ruptuwesleruptuwesl
implement -> implemeni -> implemenimplemenimp
lend -> ltnd -> datatatatatatatatat
inhaled -> inhalcd -> accidental serotoni
Boise -> Boisr -> re a boisre a boisr
Osborne -> Osborze -> zelelelelelelelelel
slips -> slyps -> entrententententent
defeating -> defeatgng -> eatgngngngngngngngn
retain -> retail -> leave a menudoretai
unambiguously -> unambiguoujly -> lllllllllllllllllll
inherited -> inoerited -> ededededededededede
blessings -> bqessings -> andbestqessingsandb
Mahabharata -> Mahabharatq -> qtqtqtqtqtqtqtqtqtq
piety -> biety -> bietybietybietybiet
unclear -> ukclear -> kclearedclearedclea
impact -> impacr -> epidermisteristeris
merits -> mexits -> exitsala.comexitsal
shoe -> sooe -> u sooeu sooeeeeeeee
Citing -> Ciring -> Ciring Ciring Cirin
Dame -> Dace -> DaceDaceDaceDaceDac
Portions -> Portoons -> s a s a s a s a s a
gradually -> graduaily -> yegraduailyegraduai
Piedmontese -> Piesmontese -> est de la construct
excepting -> etcepting -> therapeuticsearcher
Kartikeya -> Kartikesa -> artikesasasasasasas
ranging -> ringing -> ingingingingingingi
adieu -> adqeu -> daeueueueueueueueue
upgrade -> qpgrade -> percentageservicese
Ketan -> Ketae -> etaevaevaevaevaevae
crowds -> criwds -> contentnewsnewsnews
accident -> accideet -> eeteeteeteeteeteete
