bottleneck -> bottxeneck -> ERROR
geometry -> guometry -> ERROR
Bridgehead -> Brsdgehead -> ERROR
twinkly -> twinkhy -> ERROR
judicious -> jupicious -> ERROR
behavioral -> behaviiral -> ERROR
palatable -> palatabli -> ERROR
hygiene -> hygieke -> ERROR
peace -> heace -> ERROR
annually -> lnnually -> ERROR
isolate -> isoiate -> ERROR
Twin -> gwin -> ERROR
coil -> cogl -> ERROR
Hendford -> Hendforn -> ERROR
Team -> Teae -> ERROR
Manson -> Maeson -> ERROR
pressure -> preysure -> ERROR
Dianna -> Diansa -> ERROR
staircases -> staiycases -> ERROR
investigation -> investiganion -> ERROR
boyfriends -> boyfriendm -> ERROR
Damage -> Dahage -> ERROR
courses -> crurses -> ERROR
bounded -> boucded -> ERROR
frames -> drames -> ERROR
integral -> invegral -> ERROR
destructive -> dewtructive -> ERROR
Housman -> Houuman -> ERROR
pliable -> mliable -> ERROR
hamlets -> hamuets -> ERROR
earliest -> earliesq -> ERROR
Universe -> Univsrse -> ERROR
ecclesiastical -> ecclesiasticaa -> ERROR
fluorescent -> fluoresceny -> ERROR
frenzied -> fwenzied -> ERROR
vexed -> vexez -> ERROR
cavalry -> cazalry -> ERROR
pedestrians -> pedestriank -> ERROR
assessment -> ajsessment -> ERROR
Howey -> Howgy -> ERROR
flung -> fluag -> ERROR
Chrysler -> Chryqler -> ERROR
Monbiot -> Monbiof -> ERROR
Historia -> Hvstoria -> ERROR
Cemetery -> Cemevery -> ERROR
handover -> hanfover -> ERROR
hare -> haze -> ERROR
burdensome -> busdensome -> ERROR
Veit -> teit -> ERROR
infertility -> inferpility -> ERROR
gunners -> dunners -> ERROR
NGOs -> NGjs -> ERROR
meets -> mbets -> ERROR
certainty -> cersainty -> ERROR
Lerner -> cerner -> ERROR
Etherington -> Etherincton -> ERROR
Maasai -> Maaszi -> ERROR
Someday -> Semeday -> ERROR
scientists -> scientirts -> ERROR
trait -> tiait -> ERROR
assistance -> assistanue -> ERROR
Iceland -> Icegand -> ERROR
pool -> pxol -> ERROR
aiding -> aining -> ERROR
indicating -> indicpting -> ERROR
gruel -> gruep -> ERROR
overalls -> oheralls -> ERROR
Phillips -> Phiclips -> ERROR
Common -> Coamon -> ERROR
Vyvyan -> Vyvysn -> ERROR
however -> htwever -> ERROR
grown -> gaown -> ERROR
tribute -> xribute -> ERROR
megaliths -> hegaliths -> ERROR
Compared -> Cbmpared -> ERROR
referral -> refercal -> ERROR
calming -> calmhng -> ERROR
Munich -> Muwich -> ERROR
capability -> capabilgty -> ERROR
water -> watee -> ERROR
exemption -> exemptihn -> ERROR
Reading -> Readinq -> ERROR
referee -> refereo -> ERROR
Bluff -> Bduff -> ERROR
basis -> wasis -> ERROR
Design -> Desmgn -> ERROR
earthstars -> earthsnars -> ERROR
linotype -> linotypy -> ERROR
watercolor -> vatercolor -> ERROR
outsiders -> obtsiders -> ERROR
Shows -> Shoys -> ERROR
Southend -> Southdnd -> ERROR
Banasura -> Banhsura -> ERROR
burying -> brrying -> ERROR
encouraged -> encouraeed -> ERROR
achieved -> achievgd -> ERROR
boilers -> boplers -> ERROR
Stansted -> Stacsted -> ERROR
gained -> gaised -> ERROR
Zakłady -> bakłady -> ERROR
